##############
#      #     #
# ## # # #   #
G  # # # #   #
#### ### ## ##
#        #  ##
# # # ## # ###
# # # ## #   #
# # #  # ### #
# # ## # # # #
# #  # # # # #
# ## ###   # #
#  #   ##### #
##############